NO ./textures/creepy_1.png
EA ./textures/creepy_2.png
SO ./textures/creepy_3.png
WE ./textures/creepy_4.png

F 15,6,40
C 35,19,73



1111111111111111111111111111111
1000000000000000000000000000001
1011110111111111111111111011101
1010000100000001000000010010001
1010111101111101011111011110101
1010000001000001010000010000101
1010111111011111011111011110101
1010000010000000000000010000101
1011101010111111111111010111101
1000101010000000000000010100001
10N0101010111111111111010110111
10001000010000000D0000010000001
1111111111111111111111111111111
