1111111111111111111111111111111111
100000000000000000000000000000000000000000111111111
        1110000000000100000000000001110000011111111
100000000000000000000000000000000000000000111111111
10000000000000000000000000 0000000000000000101111111
100000000000000000000000000000000000000000111111111
100000000000000000000000000000000000000000111111111
10000000000000 0000000000000000000000000000111111111
     100000000000000000000000000000000000000000111111111
100000000000000000000000000000000000000000111111111
111111111111111111111111111111111111111111111111111
