NO ./textures/greystone.png
EA ./textures/gray_hitler.png
SO ./textures/grayeagle.png
WE ./textures/grayflag.png


F 70,70,70
C 56,56,56



        1111111111111111111111111
        1000000000110000000000001
        1011000001110000000000001
        1001000000000000000000001
111111111011000001110000100000001
10000000001100000111011111D111111
11110111111111011100000010001
11110111111111011101010010001
11000000110101011100000010001
10000000000000001100000010001
100000000000000011010100D0001
1100000111010101111101111000111
11110111 1110101 1011110100N1
11111111 1111111 111111111111
